#,#,#,#,#,#,#,#,#,#,#,#,#,#,#,#,#,#,#,#,#,#,#,#,#,-,-,-,-,-,-,-,-,-,-,-,-,-,-,-,-,-,-,-,-,
#,-,-,-,-,-,-,-,-,-,-,-,-,-,-,-,-,-,-,-,-,-,-,-,#,-,-,-,-,-,-,-,-,-,-,-,-,-,-,-,-,-,-,-,-,
#,-,-,-,-,-,-,-,-,-,-,-,-,-,-,-,-,-,-,-,-,-,-,-,#,-,-,-,-,-,-,-,-,-,-,-,-,-,-,-,-,-,-,-,-,
#,-,-,-,-,-,-,-,-,-,-,-,-,-,-,-,-,-,-,-,-,-,-,-,#,-,-,-,-,-,-,-,-,-,-,-,-,-,-,-,-,-,-,-,-,
#,-,-,-,-,-,-,-,-,-,-,-,-,-,-,-,-,-,-,-,-,-,-,-,#,-,-,-,-,-,-,-,-,-,-,-,-,-,-,-,-,-,-,-,-,
#,-,-,-,-,-,-,-,-,-,-,-,-,-,-,-,-,-,-,-,-,-,-,-,#,-,-,-,-,-,-,-,-,-,-,-,-,-,-,-,-,-,-,-,-,
#,-,-,-,-,-,-,-,-,-,-,-,-,-,-,-,-,-,-,-,-,-,-,-,#,-,-,-,-,-,-,-,-,-,-,-,-,-,-,-,-,-,-,-,-,
#,-,-,-,-,-,-,-,-,-,-,-,-,-,-,-,-,-,-,-,-,-,-,-,#,-,-,-,-,-,-,-,-,-,-,-,-,-,-,-,-,-,-,-,-,
#,-,-,-,-,-,-,-,-,-,-,-,-,-,-,-,-,-,-,-,-,-,-,-,#,-,-,-,-,-,-,-,-,-,-,-,-,-,-,-,-,-,-,-,-,
#,-,-,-,-,-,-,-,-,-,-,-,-,-,-,-,-,-,-,-,-,-,-,-,#,-,-,-,-,-,-,-,-,-,-,-,-,-,-,-,-,-,-,-,-,
#,#,#,#,#,#,#,#,#,#,#,#,#,-,-,-,-,-,-,-,-,-,-,-,#,-,-,-,-,-,-,-,-,-,-,-,-,-,-,-,-,-,-,-,-,
#,-,-,-,-,-,-,-,-,-,-,#,-,-,-,-,-,-,-,-,-,-,-,-,#,-,-,-,-,-,-,-,-,-,-,-,-,-,-,-,-,-,-,-,-,
#,-,-,-,-,-,-,-,-,-,-,-,-,-,-,-,-,-,-,-,-,-,-,-,#,-,-,-,-,-,-,-,-,-,-,-,-,-,-,-,-,-,-,-,-,
#,-,-,-,-,-,-,-,-,-,-,-,-,-,-,-,-,-,-,-,-,-,-,-,#,-,-,-,-,-,-,-,-,-,-,-,-,-,-,-,-,-,-,-,-,
#,-,-,-,-,-,-,-,-,-,-,-,-,-,-,-,-,-,-,-,-,-,-,-,#,-,-,-,-,-,-,-,-,-,-,-,-,-,-,-,-,-,-,-,-,
#,-,-,-,-,-,-,-,-,-,-,-,-,-,-,-,-,-,-,-,-,-,-,-,#,-,-,-,-,-,-,-,-,-,-,-,-,-,-,-,-,-,-,-,-,
#,-,-,-,-,-,-,-,-,-,-,-,-,-,-,-,-,-,-,-,-,-,-,-,#,-,-,-,-,-,-,-,-,-,-,-,-,-,-,-,-,-,-,-,-,
#,-,-,-,-,-,-,-,-,-,-,-,-,-,-,-,-,-,-,-,-,-,-,-,#,#,-,-,-,-,-,-,-,-,-,-,-,-,-,-,-,-,-,-,-,
#,-,-,-,-,-,-,-,-,-,-,-,-,-,-,-,-,-,-,-,-,-,-,#,#,#,-,-,-,-,-,-,-,-,-,-,-,-,-,-,-,-,-,-,-,
#,#,#,#,#,#,#,#,#,#,#,#,#,#,#,#,#,#,#,#,#,#,#,#,-,-,-,-,-,-,-,-,-,-,-,-,-,-,-,-,-,-,-,-,-,
